        +---------------------------------------------------+
        | ASCII map to show rooms' relations to each other. |
        +---------------------------------------------------+

This map is at current state only used for development process
and it is not to be shown to players.

              North

                ^
                |
    West    <---+--->   East
                |
                v

              South

+-------------------------------------------------------------------------------+
| ID | ID | ID | ID | ID | ID | ID | ID | ID | ID | ID | ID | ID | ID | ID | ID |
+-------------------------------------------------------------------------------+
| ID | ID | ID | ID | ID | ID | ID | 03 | ID | ID | ID | ID | ID | ID | ID | ID |
+-------------------------------------------------------------------------------+
| ID | ID | ID | ID | ID | ID | 02 | 01 | ID | ID | ID | ID | ID | ID | ID | ID |
+-------------------------------------------------------------------------------+
| ID | ID | ID | ID | ID | ID | ID | ID | ID | ID | ID | ID | ID | ID | ID | ID |
+-------------------------------------------------------------------------------+
| ID | ID | ID | ID | ID | ID | ID | ID | ID | ID | ID | ID | ID | ID | ID | ID |
+-------------------------------------------------------------------------------+